+--+--+--+--+--+--+--+--+--+--+
         |     |              |
+  +--+--+  +  +  +--+--+  +  +
|  |        |     |     |  |  |
+  +  +--+--+--+--+--+  +  +  +
|  |  |                    |  |
+  +  +  +--+--+--+--+--+--+--+
|     |           |           |
+  +--+--+--+--+  +--+--+--+  +
|  |           |        |     |
+  +  +--+--+  +--+--+  +  +--+
|  |  |     |     |        |  |
+--+  +--+  +--+  +  +--+--+  +
|        |        |     |     |
+  +--+  +--+--+--+--+  +  +--+
|  |  |        |        |     |
+  +  +--+--+  +  +--+--+  +--+
|           |     |           |
+--+--+--+  +  +--+  +--+--+  +
|           |        |
+--+--+--+--+--+--+--+--+--+--+
