+--+--+--+--+--+--+--+--+--+--+
         |           |     |  |
+  +--+--+  +--+--+  +  +  +  +
|  |        |     |     |  |  |
+  +  +--+--+  +  +--+  +  +  +
|        |     |        |     |
+--+--+--+  +--+  +--+--+--+--+
|        |  |     |     |     |
+  +--+  +  +  +--+  +  +  +  +
|  |  |  |  |     |  |  |  |  |
+  +  +  +  +--+  +  +  +  +  +
|  |  |     |  |     |  |  |  |
+  +  +--+--+  +  +--+  +  +  +
|  |        |  |  |        |  |
+  +--+--+  +  +  +  +--+--+  +
|           |  |  |     |     |
+--+--+--+--+  +  +--+--+  +--+
|     |     |  |  |     |     |
+  +  +--+  +  +--+  +  +--+  +
|  |                 |
+--+--+--+--+--+--+--+--+--+--+
