+--+--+--+--+--+--+--+--+--+--+
   |     |     |     |        |
+  +  +  +  +  +  +  +  +--+  +
|  |  |  |  |  |  |     |     |
+  +  +  +  +  +  +--+--+  +--+
|     |  |  |  |  |        |  |
+--+--+  +  +  +  +  +--+--+  +
|     |     |  |  |        |  |
+  +  +--+--+  +  +--+  +  +  +
|  |     |  |        |  |     |
+  +  +  +  +--+  +--+  +--+--+
|  |  |     |  |     |     |  |
+  +  +--+--+  +--+  +  +  +  +
|  |           |     |  |     |
+  +--+--+--+  +--+--+--+--+  +
|           |                 |
+--+--+--+  +--+--+--+--+--+--+
|     |  |              |     |
+  +  +  +--+--+--+--+  +  +  +
|  |                       |
+--+--+--+--+--+--+--+--+--+--+
